だ / です (da / desu): to be (basic statement ender particle)
だけ (dake): only, just
だろう (darou): probably
で (de) – 1: at, in
で (de) – 2: with, by
でしょう (deshou): I think, probably
が (ga) – 1: subject marker
が (ga) – 2: but, however
がある (gaaru): there is (used for non-living things)
がいる (gairu): there is (used for living things)
ほうがいい (hou ga ii) 1: it’d be better to (and negation thereof?)
いちばん (ichiban): the most
か (ka) 1: or (A or B, choice between 2 objects)
か (ka) 2: question particle
から (kara) 1: because, since
から (kara) – 2: from
けれども (keredomo): but, although
くらい (kurai): about, approximately
まだ (mada): still, not yet
まで (made): until, till, to, even
まえに (mae ni): before
ませんか (masen ka): let’s, won’t you
ましょう (mashou): let’s, shall we
も (mo): also, too, as well
もう (mo): already, anymore
な (na): don’t do
ないでください (naidekudasai): please don’t
なる (naru): to become
に (ni): in, at, to, for
に/へ (ni/e): to
にいく (ni iku): to go in order to
にする (nisuru): to decide on
の (no) – 1: of (indicates possessive)
の (no) – 2: Verb nominalizer
ので (node): because of, the reason is that
のがじょうず (no ga jouzu):  to be good at
のがすき (no ga suki): like / love doing
のがへた (no ga heta): to be bad at
たい (tai): want to
たことがある (takotogaaru): have done before
ている (teiru): is/are/am doing
てください (tekudasai): please do…
てもいい (temo ii): is okay, is alright to, can
てから (tekara): after doing
てはいけない (tewaikenai): must not, may not
と (to): and, with
つもりだ: plan to, intend to
や (ya): and
より ~ のほうが ~ (yori ~ nohouga ~): is more ~ than
